11111111
1P000001
11111111
1E0000C1
11111111