111111
1P0Z01
100C01
1000E1
111111