111111
1P0000
100C01
1000E1
111111