111111
100001
100P001
100001
111111