1111111111111111111111111111111111
1101111111111111111111111X11101111
100011111111111111111111XXX1000111
10000111000000000000001XXXX0000011
10000110000000000000001XXXXX000011
100000000000000000000000XXXCC00XX1
100000000000000000000000XXXCCXXXX1
1000011000000000000001100000XXXXX1
10001111000000000000111100000XXXX1
100001100000000000000110000000XX01
1000000000000000000000000000000001
1000000000000000000000000000000001
1000000000000XX0000000000000000001
100000000000X00X000000000000000001
1000000000000XX0000000000000000001
1100000000000000000000000000000011
1110000000000000000000000000000111
111111E000000000000000000000P11111
1111111100000000000000000011111111
1111111111000000000000011111111111
1111111111111111111111111111111111