11111111111111111111111111111111111111
10000000111000000000001111001111100001
10000011000111111111110000110000010001
10000010000000000000000000000001100001
10000010000000000000000000000000010001
10000100000000000000000000000000001001
10011100000000000000000000000000111001
10010000010000000000001000000000100001
10001000001000000000010000000001000001
10000110000000000000000000000110000001
10000001111111111000000001111000000001
10000000000000000000000000000000000001
10000P0000C000000000000C0000000E000001
11111111111111111111111111111111111111