1111111111
1000000001
10C0000001
100100E001
1010100001
10010P0001
1000000001
1000000C01
1111111111