11111111111111111111111111
1P000000000100000000000001
10000000000100000000000001
100000C000010000C000000001
10000011111111111000000001
10000000000100000000000001
10000000000100000C00000001
10000C000000000000000001E1
100000000001000000000001C1
11111111111111111111111111