11111111111
1P0000EC001
11111111111