1111111111111111111111111111111111111111111111111111111111111111111
1111111111111111111111100000000000000000000011111111111111111111111
1111111111111111000000000000000000000000000000000001111111111111111
1111111111110000000000000000000000000000000000000000000111111111111
1111111110000000000000000000000000000000000000000000000001111111111
1111111000000000000000000000000000000000000000000000000000011111111
1111100000000000000000000000000C0C000000000000000000000000000111111
1110000000000000000000000000000000000000000000000000000000000001111
1100000000000000000000000000000000000000000000000000000000000000111
1100000000111110000000000000000000000000000000000001111100000000011
1100000001111111000000000000000000000000000000000011111110000000011
1100000011110011100000000000000000000000000000000111001111000000011
1100000011110011100000000000000X0X000000000000000111001111000000011
1100000011110011100000000000000000000000000000000111001111000000011
1100000001111111000000000000000000000000000000000011111110000000011
1100000000111110000000000000000000000000000000000001111100000000011
1100000000000000000000000000000P00000000000000000000000000000000011
1100000000000000000000000000001110000000000000000000000000000000011
1100000000000000000000000000011111000000000000000000000000000000011
110000000000000000C0000000011111111000000000C0000000000000000000011
1100000000000000000000000011111E11111000000000000000000000000000011
1100000000000000000000000001110001110000000000000000000000000000011
1111000000000000000000000000000000000000000000000000000000000001111
1111110000000000000000000000000000000000000000000000000000000111111
1111111100000000000000000000000000000000000000000000000000011111111
1111111110000001100000001100000000001100000001100000001111111111111
1111111110000X01100000001100000000001100000001100X00001111111111111
1111111110000001100000001100000C00001100000001100000001111111111111
1111111111000011110000011110000000011110000011110000011111111111111
11111111111C0111111100111111100011111110011111110C01111111111111111
1111111111111111111111111111111111111111111111111111111111111111111
