111111111111111111111111111111111111111111111111111111111111111111111
111111111111111111111111111100000000000111111111111111111111111111111
1111111111111111100000000000000000C0000000000000000000011111111111111
111111111111110000000000000000000000000000000000000000000001111111111
111111111110000000000000000000000000000000000000000000000000011111111
111111110000000000000000000000000000000000000000000000000000000011111
111111000000000000000000000000000000000000000000000000000000000001111
111100000000000000000000000000000000000000000000000000000000000000111
110000000000000000000000000000000000000000000000X00000000000000000011
110000000000000000000000000000000000000000000000000000000000000000011
110000000111000000000000000000000000000000000000000000000111000000011
110000011111110000000000000000000000000000000000000000011111100000011
110000111101111000000000000000000000000000000000000000111101110000011
110000111101111000000000X00000000000000000000000000000111101110000011
110000111101111000000000000000000000000000000000000000111101110000011
110000111101111000000000000000000000000000000000000000111101110000011
1100000111111100000000000000000000P0000000000000000000011111100000011
110000001111100000000000000000000111000000000000000000001111000000011
110000000011000000000000000000001111100000000000000000000110000000011
110000000000000000C00000000000111111111000000000000000000000000000011
110000000000000000000000000001111111111100000000000000000000000000011
1100000000000000000000000000111111E0111110000000000000000000000000011
110000000000000000000000000001110000011000000000000000000000000000011
111100000000000000000000000000000000000000000000000000000000000000111
111110000000000000000000000000000000000000000000000000000000000001111
111111111000000000000000000000000000000000000000000000000011111111111
111111111000000110000000011000000000001100000000110000000011111111111
111111111000X00110000000011000000000001100000000110000000011111111111
11111111100000011000000001100000C000001100000000110000C00011111111111
111111111100001111000000111100000000011110000001111000000111111111111
11111111111C011111110001111111000011111111100111111110011111111111111
111111111111111111111111111111111111111111111111111111111111111111111